10,10,10,10,10,10,11,1,1,9,10,10,10,10,10,10
11,13,65,13,13,65,14,19,19,12,65,13,13,65,13,9
11,23,69,23,23,69,23,22,22,23,69,23,23,69,23,9
14,1,1,1,1,1,1,112,113,1,1,1,1,1,1,9
1,1,1,1,1,1,1,1,1,1,1,1,1,1,1,9
8,1,1,1,1,1,1,1,1,1,1,1,1,1,1,9
11,1,1,1,1,1,1,1,1,1,1,1,1,1,1,9
11,1,1,1,1,1,1,1,1,1,1,1,1,1,1,9
17,7,7,7,7,7,7,7,7,7,7,7,7,7,7,18
