10,10,10,10,10,10,11,1,1,9,10,10,10,10,10,10
11,13,65,20,63,65,14,1,1,12,65,63,20,65,13,9
11,23,69,21,64,69,23,1,1,23,69,64,21,69,23,9
11,1,1,1,1,1,1,1,1,1,1,1,1,1,1,9
11,1,1,30,1,1,1,1,1,1,1,1,30,1,1,9
11,1,1,1,1,1,1,1,1,1,1,1,1,1,1,9
11,1,1,30,1,1,1,1,1,1,1,1,30,1,1,9
11,1,1,1,1,1,1,1,1,1,1,1,1,1,1,9
17,7,7,7,7,7,8,1,1,6,7,7,7,7,7,18
