10,10,10,10,10,10,10,10,10,10,10,10,10,10,10,10
11,13,65,13,13,65,13,13,65,13,13,65,13,13,65,9
11,23,69,23,23,69,23,23,69,23,23,69,23,23,69,9
11,76,76,76,1,1,1,1,1,1,1,1,1,1,1,12
11,76,76,76,1,1,1,1,1,1,1,1,1,1,1,1
11,76,4,76,1,1,1,1,82,1,1,1,1,1,1,6
11,76,76,76,1,1,1,1,1,1,1,1,1,1,1,9
11,76,76,76,1,1,1,1,1,1,1,1,1,1,1,9
17,7,7,7,7,7,7,7,7,7,7,7,7,7,7,18
