10,10,10,10,10,10,11,71,71,9,10,10,10,10,10,10
11,13,13,13,13,13,13,19,19,13,13,13,13,13,13,9
11,23,23,23,23,23,23,22,22,23,23,23,23,23,23,9
11,70,70,70,70,70,70,70,70,70,70,70,70,70,70,9
11,70,70,70,70,70,70,70,70,70,70,70,70,70,70,9
11,70,70,70,70,70,70,70,70,70,70,70,70,70,70,9
11,70,70,70,70,70,70,70,70,70,70,70,70,70,70,9
11,70,70,70,70,70,70,70,70,70,70,70,70,70,70,9
17,7,7,7,7,7,8,70,70,6,7,7,7,7,7,18
