10,10,10,10,10,10,11,1,1,9,10,10,10,10,10,10
11,13,13,13,13,13,14,1,1,12,13,13,13,13,13,9
11,23,23,23,23,23,23,1,1,23,23,23,23,23,23,9
14,1,1,1,1,1,1,1,1,1,1,1,1,1,1,12
1,1,1,1,1,1,1,1,1,1,1,1,1,1,1,1
8,1,1,1,1,1,1,1,1,1,1,1,1,1,1,6
11,1,1,1,1,1,1,1,1,1,1,1,1,1,1,9
11,1,1,1,1,1,1,1,1,1,1,1,1,1,1,9
17,7,7,7,7,7,8,1,1,6,7,7,7,7,7,10
