10,10,10,10,10,10,10,10,10,10,10,10,10,10,10,10
11,13,13,20,65,13,55,20,65,13,55,20,65,13,13,9
11,47,47,21,69,23,56,21,69,23,56,21,69,23,23,9
11,48,48,1,1,1,1,1,1,1,1,1,1,1,1,9
11,1,1,1,1,1,1,1,1,1,1,1,1,4,1,9
11,1,1,1,1,1,1,1,1,1,1,1,1,1,1,9
11,1,1,1,1,1,1,1,1,1,1,1,1,1,1,9
11,1,1,1,1,1,1,1,1,1,1,1,1,1,1,9
17,7,7,7,7,7,8,1,1,6,7,7,7,7,7,18
