10,10,10,10,10,10,10,10,10,10,10,10,10,10,10,10
11,13,13,13,13,13,13,20,20,13,13,13,13,13,13,9
11,23,23,23,23,23,23,21,21,23,23,23,23,23,23,9
11,71,71,71,71,71,71,71,71,71,71,71,71,71,4,9
11,71,71,71,71,71,71,71,71,71,71,71,71,71,71,9
11,71,71,71,71,71,71,71,71,71,71,71,71,71,71,9
11,71,71,71,71,71,71,71,71,71,71,71,71,71,71,9
11,71,71,71,71,71,71,71,71,71,71,71,71,71,71,9
17,7,7,7,7,7,8,71,71,6,7,7,7,7,7,18
