10,10,10,10,10,10,11,71,71,9,10,10,10,10,10,10
11,43,44,43,44,43,44,71,71,12,68,13,13,57,65,9
11,49,50,49,50,49,50,71,71,23,69,23,23,58,69,9
14,45,46,45,46,45,46,71,71,71,71,71,71,71,88,9
34,71,71,71,71,71,71,71,71,71,71,71,71,71,30,9
71,71,71,71,71,71,71,71,8,71,71,71,71,71,71,9
11,71,71,71,71,71,71,71,71,71,71,71,71,71,71,9
11,71,71,71,71,71,71,71,71,71,71,71,71,71,71,9
17,7,7,7,7,7,8,71,71,6,7,7,7,7,7,18
