10,10,10,10,10,10,10,10,10,10,10,10,10,10,10,10
11,13,65,13,13,13,13,68,68,35,13,55,57,65,13,9
11,23,69,23,23,23,23,69,69,23,23,56,58,69,23,9
11,4,74,74,74,72,72,72,72,72,72,72,72,32,32,68
11,74,74,2,74,72,32,32,36,32,32,36,32,32,32,69
11,31,31,31,36,31,32,32,37,32,32,37,32,71,71,71
11,31,31,31,37,31,39,71,71,71,71,71,71,71,71,6
11,71,71,71,71,71,71,71,71,71,71,71,71,71,71,9
17,7,7,7,7,7,8,71,71,6,7,7,7,7,7,18
