10,10,10,10,10,10,10,10,10,10,10,10,10,10,10,10
11,12,65,61,13,59,65,14,19,12,65,55,57,65,14,9
11,23,69,62,23,60,69,23,22,23,69,56,58,69,23,9
14,1,1,1,1,72,72,72,72,72,72,1,1,1,1,12
72,1,1,2,1,72,72,72,72,72,72,1,1,4,1,72
8,1,1,1,1,72,72,72,72,72,72,1,1,1,1,6
11,1,1,1,1,72,72,72,72,72,72,1,1,1,1,9
11,1,1,1,1,72,72,72,72,72,72,1,1,1,1,9
17,7,7,7,7,7,8,72,72,6,7,7,7,7,7,18
