10,10,10,10,10,10,11,1,1,9,10,10,10,10,10,10
11,13,13,65,13,57,14,1,1,12,57,13,68,13,13,9
11,23,23,23,23,58,23,1,1,23,58,23,23,23,23,9
14,1,1,1,1,1,1,1,1,1,1,1,1,1,1,9
1,1,1,1,1,1,1,1,1,1,1,1,1,1,1,9
8,1,1,80,81,1,1,1,1,1,1,1,80,81,1,9
11,1,1,1,1,1,1,1,1,1,1,1,1,1,1,9
11,1,1,1,1,1,1,1,1,1,1,1,1,1,1,9
17,7,7,7,7,7,7,7,7,7,7,7,7,7,7,18
