10,10,10,10,10,10,10,10,10,10,10,10,10,10,10,10
11,13,13,13,13,13,13,13,13,13,13,13,13,13,13,9
11,23,23,23,23,23,23,23,23,23,23,23,23,23,23,9
11,1,1,1,1,1,1,1,1,72,72,72,76,72,72,9
11,1,1,1,1,1,1,1,1,72,72,76,4,76,72,9
11,1,1,1,1,1,1,1,1,72,72,72,76,72,72,9
11,1,1,1,1,1,1,1,1,72,72,76,4,76,72,9
11,1,1,1,1,1,1,1,1,72,72,72,76,72,72,9
17,7,7,7,7,7,8,1,1,6,7,7,7,7,7,18
