10,10,10,10,10,10,11,1,1,9,10,10,10,10,10,10
11,13,13,65,13,57,14,19,19,12,57,65,66,67,68,9
11,23,23,69,23,58,23,22,22,23,58,69,69,69,69,9
14,1,1,1,1,1,1,1,1,1,1,1,1,1,1,9
1,1,1,1,1,1,1,1,1,1,1,1,1,1,1,9
8,1,1,80,81,1,1,1,1,1,1,1,80,81,1,9
11,1,1,1,1,1,1,1,1,1,1,1,1,1,1,9
11,1,1,1,1,1,1,1,1,1,1,1,1,1,1,9
17,7,7,7,7,7,7,7,7,7,7,7,7,7,7,18
