10,10,10,10,10,10,11,71,71,9,10,10,10,10,10,10
11,13,13,65,13,57,14,71,71,12,57,65,66,67,68,9
11,23,23,69,23,58,23,71,71,23,58,69,69,69,69,9
11,70,70,70,70,70,70,70,70,70,70,70,70,70,70,9
11,70,70,70,70,70,70,70,70,70,70,70,70,70,70,9
11,70,70,70,70,70,70,70,70,70,70,70,70,70,70,9
11,70,70,70,70,70,70,70,70,70,70,70,70,70,70,9
11,82,70,70,70,70,70,70,70,70,70,70,70,70,70,9
17,7,7,7,7,7,7,7,7,7,7,7,7,7,7,18
