10,10,10,10,10,10,11,1,1,9,10,10,10,10,10,10
11,13,65,13,13,65,14,1,1,12,65,13,13,65,13,9
11,23,69,23,23,69,23,76,76,23,69,23,23,69,23,9
11,1,1,1,76,76,76,76,76,76,76,76,1,1,1,9
11,1,76,76,76,76,76,76,76,76,76,76,76,76,1,9
11,1,76,76,76,76,76,76,76,76,76,76,76,76,1,9
11,1,76,76,76,1,1,1,1,1,1,76,76,76,1,9
11,1,76,76,1,4,4,4,4,4,4,1,76,76,1,9
17,7,7,7,7,7,7,7,7,7,7,7,7,7,7,18
