10,10,10,10,10,10,11,1,1,9,10,10,10,10,10,10
11,55,65,55,55,65,14,19,19,12,65,55,55,65,55,9
11,56,69,56,56,69,23,22,22,23,69,56,56,69,56,9
11,1,1,1,1,1,1,1,1,1,1,1,1,1,1,12
11,1,1,1,1,1,1,1,1,1,1,1,1,1,1,1
11,1,1,83,1,1,1,1,1,1,1,1,83,1,1,6
11,1,1,1,1,1,1,1,1,1,1,1,1,1,1,9
11,4,1,1,1,1,1,1,1,1,1,1,1,1,4,9
17,7,7,7,7,7,8,1,1,6,7,7,7,7,7,18
