10,10,10,10,10,10,11,70,70,9,10,10,10,10,10,10
11,13,65,13,13,65,14,70,70,12,65,13,13,65,13,9
11,23,69,23,23,69,23,70,70,23,69,23,23,69,23,9
13,70,70,70,70,70,70,70,70,70,70,70,70,70,70,9
23,70,70,70,70,70,70,70,70,70,70,70,70,70,70,68
70,70,70,70,70,70,70,70,70,70,70,70,70,70,70,54
70,70,70,70,70,70,70,70,70,70,70,70,70,70,70,70
8,70,70,70,70,70,70,70,70,70,70,70,70,70,70,70
17,7,7,7,7,7,7,7,7,7,7,7,7,7,7,18
