10,10,10,10,10,10,11,71,71,9,10,10,10,10,10,10
11,43,44,63,59,68,14,19,19,12,68,13,20,57,65,9
11,49,50,64,60,69,23,22,22,23,69,23,21,58,69,9
14,45,46,71,71,71,71,71,71,71,71,71,71,71,88,9
1,71,71,71,71,71,71,71,71,71,71,71,71,71,30,9
71,71,71,71,71,71,71,71,71,71,71,71,71,71,71,9
11,71,71,71,71,71,71,71,71,71,71,71,71,71,71,9
11,71,71,71,71,71,71,71,71,71,71,71,71,71,4,9
17,7,7,7,7,7,8,71,71,6,7,7,7,7,7,18
