10,10,10,10,10,10,11,72,76,9,10,10,10,10,10,10
11,65,61,63,59,55,14,72,76,12,55,13,20,57,65,9
11,69,62,64,60,56,23,72,72,23,56,23,21,58,69,9
14,1,1,1,1,1,72,76,72,72,1,1,1,1,1,9
1,1,1,1,1,1,72,72,72,72,1,1,1,1,1,9
8,1,1,1,1,1,72,72,76,72,1,1,1,1,1,9
11,1,1,1,1,1,72,72,72,72,1,1,1,1,1,9
11,1,1,1,1,1,76,72,72,72,1,1,1,1,1,9
17,7,7,7,7,7,8,72,72,6,7,7,7,7,7,18
